W=100,H=100

	*	*	*	*	*	*	*	*	*	*	*	*	*	*	*	*	*	*	*	*	*	*	*	*  	
*																								   *
*																								   *															
*																								   *
*																								   *
*																								   *
*																								   *
*																								   *
*																								   *
*																								   *
*																								   *
*																								   *
*																								   *
*																								   *
*																								   *
*																								   *
*																								   *
*																								   *
*																								   *
*																								   *
*																								   *
*																								   *
*																								   *
*																								   *
*																								   *
*																								   *
*																								   *
*																								   *
*																								   *
*																								   *
*																								   *
*																								   *
*																								   *
*																								   *
*																								   *
*																								   *
*																								   *
*																								   *
*																								   *
*																								   *
*																								   *
*																								   *
*																								   *
*																								   *
*																								   *
*																								   *
*																								   *
*																								   *
*																								   *
*																								   *
*																								   *
*																								   *
*																								   *
*																								   *
*																								   *
*																								   *
*																								   *
*																								   *
*																								   *
*																								   *
*																								   *
*																								   *
*																								   *
*																								   *
*																								   *
*																								   *
*																								   *
*																								   *
*																								   *
*																								   *
*																								   *
*																								   *
*																								   *
*																								   *
*																								   *
*																								   *
*																								   *
*																								   *
*																								   *
*																								   *
*																								   *
*																								   *
*																								   *
*																								   *
*																								   *
*																								   *
*																								   *
*																								   *
*																								   *
*																								   *
*																								   *
*																								   *
*																								   *
*																								   *
*																								   *
*																								   *
*																								   *
*																								   *
	*	*	*	*	*	*	*	*	*	*	*	*	*	*	*	*	*	*	*	*	*	*	*	*